31 31 31 31 31 31 31 31 31 31 31 31 31 31 31 31 31 31 31 31 31 31 31 31 31 31 31 31 31 31 31 31
31 00 00 00 00 27 00 00 25 00 00 28 00 00 00 00 27 00 00 26 00 00 00 00 00 00 00 00 26 00 00 31
31 00 00 00 00 00 28 00 00 00 00 00 00 14 07 13 00 00 00 00 00 00 14 13 00 00 00 00 00 00 00 31
31 00 26 25 00 00 00 31 31 31 31 31 00 11 15 18 13 25 00 00 00 00 10 18 13 27 00 00 00 25 00 31
31 00 00 00 00 31 31 31 00 00 00 00 00 00 11 08 12 00 00 31 31 31 11 08 12 00 00 00 00 00 00 31
31 00 00 00 31 31 00 00 27 00 00 00 27 00 00 00 00 00 31 31 00 00 00 00 00 00 00 00 31 00 27 31
31 00 00 00 31 00 28 00 00 00 00 31 31 31 31 31 31 31 31 00 00 00 00 31 00 00 25 00 31 00 00 31
31 00 00 00 31 00 00 00 00 00 00 00 00 00 00 27 00 00 00 00 27 00 00 31 31 00 00 00 31 00 00 31
31 00 25 00 31 00 00 00 25 00 00 27 00 00 00 00 00 00 00 00 00 00 00 00 31 00 00 31 31 00 00 31
31 00 00 00 00 27 00 00 00 00 00 00 00 00 00 00 00 26 00 00 00 25 00 00 31 00 00 31 00 00 26 31
31 00 00 25 00 00 00 00 00 31 00 00 14 13 00 00 00 00 00 00 00 00 00 00 31 31 00 31 00 00 00 31
31 00 00 00 00 00 28 00 31 31 00 14 17 18 13 00 00 00 00 00 28 00 00 00 00 31 00 31 00 00 00 31
31 26 00 31 00 00 00 00 31 31 00 10 01 01 18 13 00 00 00 00 00 00 00 00 00 31 31 31 00 25 00 31
31 00 00 31 00 25 00 00 00 31 00 10 01 34 01 09 00 00 25 00 28 00 00 00 00 31 31 00 00 00 00 31
31 00 00 31 00 00 00 00 00 31 00 11 15 01 01 09 00 00 00 00 00 00 26 00 00 31 00 00 28 00 00 31
31 00 31 31 00 00 27 00 00 31 00 00 11 15 16 12 00 25 00 31 00 00 00 00 00 31 00 00 00 00 00 31
31 00 31 00 00 00 00 00 31 31 00 00 00 11 12 00 00 00 00 31 26 00 00 00 00 00 00 00 00 00 00 31
31 00 31 00 00 00 00 00 00 31 00 00 00 00 00 27 00 00 31 31 00 00 00 27 00 00 00 14 07 13 00 31
31 00 31 00 14 13 00 00 00 00 00 00 00 27 00 00 25 00 31 26 00 00 00 00 00 00 00 11 15 09 00 31
31 31 31 00 10 09 00 26 00 00 00 00 31 00 00 00 00 00 31 00 00 00 00 00 00 00 00 00 11 12 00 31
31 00 00 00 10 09 00 00 00 00 00 00 31 00 00 00 00 00 31 00 00 00 25 00 00 00 00 00 00 00 25 31
31 00 00 14 17 09 00 25 00 00 00 00 31 00 00 25 00 31 31 00 00 00 00 00 00 31 00 00 25 00 00 31
31 00 00 11 08 12 00 00 28 00 27 00 31 31 00 00 00 31 00 26 00 28 00 00 27 31 31 00 00 00 00 31
31 27 00 00 00 00 00 00 00 00 00 00 26 31 00 00 00 31 00 00 00 00 00 00 00 31 31 00 00 00 00 31
31 00 00 25 00 31 31 31 31 31 31 00 00 00 00 00 00 31 00 00 00 14 13 00 00 31 31 31 00 27 00 31
31 00 00 00 00 00 00 27 00 00 31 31 00 25 00 00 00 31 00 00 14 17 09 00 00 31 00 31 00 00 00 31
31 26 00 00 00 00 00 00 00 28 00 31 31 00 00 00 31 31 00 00 10 16 12 00 31 31 00 31 00 00 00 31
31 00 00 00 31 00 14 07 13 00 00 00 31 31 00 00 31 00 00 00 10 09 00 00 31 00 00 00 00 00 00 31
31 00 00 00 31 00 11 15 09 00 26 00 00 31 31 31 31 00 25 00 11 12 00 00 31 00 00 00 26 00 27 31
31 00 25 00 00 00 00 11 12 00 00 00 26 00 00 00 00 00 00 00 00 00 26 00 31 26 00 00 00 00 00 31
31 00 00 00 27 00 00 00 00 25 00 00 00 27 00 00 00 25 00 00 00 00 00 00 31 00 00 28 00 00 00 31
31 31 31 31 31 31 31 31 31 31 31 31 31 31 31 31 31 31 31 31 31 31 31 31 31 31 31 31 31 31 31 31
01 02 03 04 05 06 07 08 09 10 11 12 13 14 15 16 17 18 19 20 21 22 23 24 25 26 27 28 29 30 31 32