31 31 31 31 31 31 31 31 31 31 31 31 31 31 31 31
31 30 31 01 01 01 01 01 01 01 01 01 01 01 01 31
31 01 31 01 31 31 31 31 31 31 31 31 31 31 01 31
31 01 31 01 31 01 01 01 01 01 01 01 01 31 01 31
31 01 01 01 31 01 31 31 01 01 01 01 01 01 01 31
31 01 31 31 31 01 01 31 01 31 31 31 31 31 01 31
31 01 31 01 31 31 01 31 01 31 01 01 01 31 01 31
31 01 31 01 01 01 01 01 01 01 01 31 01 31 01 31
31 01 31 01 31 01 31 31 31 01 31 31 01 31 01 31
31 01 31 01 31 01 01 31 27 01 01 31 01 01 01 31
31 01 31 31 31 31 31 31 31 31 31 31 01 31 01 31
31 01 31 01 01 01 01 01 01 01 31 01 01 31 01 31
31 01 31 01 31 31 31 31 31 01 31 01 31 31 01 31
31 01 01 01 01 01 01 01 31 01 31 01 31 01 01 31
31 01 31 01 31 31 01 31 31 01 31 31 31 01 31 31
31 31 31 31 31 31 31 31 31 31 31 31 31 31 31 31
