31 31 31 31 31 31 31 31 31 31 31 31 31 31 31 31
31 31 31 31 31 31 31 31 31 31 31 31 31 31 31 31
31 31 01 01 01 01 31 01 01 01 01 31 31 31 31 31
31 31 01 30 01 01 31 01 31 31 01 31 31 31 31 31
31 31 01 01 01 01 01 01 31 31 01 31 31 31 31 31
31 31 01 01 01 01 31 31 31 31 01 31 01 01 31 31
31 31 31 31 31 01 31 31 31 31 01 31 01 31 31 31
31 31 31 31 01 01 31 31 01 01 01 31 01 01 31 31
31 31 31 31 01 31 31 31 31 31 31 31 31 01 31 31
31 31 31 31 01 01 31 31 31 01 01 01 31 01 31 31
31 31 31 31 01 01 31 31 31 01 27 01 31 01 31 31
31 31 31 31 31 01 31 31 31 01 01 01 31 01 31 31
31 31 31 31 31 01 31 31 31 01 01 01 31 01 31 31
31 31 31 31 31 01 31 31 31 31 31 31 31 01 31 31
31 31 31 31 31 01 01 01 01 01 01 01 01 01 31 31
31 31 31 31 31 31 31 31 31 31 31 31 31 31 31 31