31 31 31 31 31 31 31 31 31 31 31 31 31 31 31 31
31 30 31 01 02 02 02 02 01 01 01 01 01 01 01 31
31 01 31 01 31 31 31 31 31 31 31 31 31 31 01 31
31 01 31 01 31 01 01 01 02 02 00 00 01 31 01 31
31 00 00 01 31 01 31 31 02 01 00 02 02 02 01 31
31 00 31 31 31 01 01 31 01 31 31 31 31 31 01 31
31 00 31 01 31 31 01 31 00 31 01 01 01 31 01 31
31 00 31 01 01 01 01 00 00 01 01 31 01 31 01 31
31 01 31 01 31 01 31 31 31 01 31 31 01 31 00 31
31 01 31 01 31 01 01 31 27 02 02 31 01 01 00 31
31 01 31 31 31 31 31 31 31 31 31 31 01 31 00 31
31 02 31 01 00 00 00 01 01 01 31 01 01 31 00 31
31 02 31 02 31 31 31 31 31 01 31 01 31 31 00 31
31 01 01 02 01 02 02 01 31 01 31 01 31 01 01 31
31 01 31 02 31 31 01 31 31 01 31 31 31 01 31 31
31 31 31 31 31 31 31 31 31 31 31 31 31 31 31 31