31 31 31 31 31 31 31 31 31 31 31 31 31 31 31 31
31 31 31 31 31 31 31 31 31 31 31 31 31 31 31 31
31 31 00 00 00 00 00 00 00 00 00 00 00 00 31 31
31 31 00 31 31 31 31 31 31 31 31 31 31 00 31 31
31 31 00 31 01 01 01 31 01 01 01 31 31 00 31 31
31 31 00 31 01 31 01 31 01 31 01 31 31 00 31 31
31 31 00 31 01 31 01 31 01 31 01 31 31 00 31 31
31 31 30 31 01 31 01 31 01 31 01 31 31 27 31 31
31 31 01 31 01 31 01 31 01 31 01 31 31 01 31 31
31 31 01 31 01 31 01 31 01 31 01 31 31 01 31 31
31 31 01 31 01 31 01 31 01 31 01 31 31 01 31 31
31 31 01 31 01 31 01 31 01 31 01 31 31 01 31 31
31 31 01 31 01 31 01 31 01 31 01 31 31 01 31 31
31 31 01 01 01 31 01 01 01 31 01 01 01 01 31 31
31 31 31 31 31 31 31 31 31 31 31 31 31 31 31 31
31 31 31 31 31 31 31 31 31 31 31 31 31 31 31 31