02 02 02 02 02 02 02 02 02 02 02 02 02 02 02 02 02 02 02 02 02 02 02 02 02 02 02 02 02 02 02 02 02 02 02 02 02 02 02 02 02 02 02 02 02 02 02 02 02 02
02 02 02 02 02 02 02 02 02 02 02 02 02 02 02 02 02 02 02 02 02 02 02 02 02 02 02 02 02 02 02 02 02 02 02 02 02 02 02 02 02 02 02 02 02 02 02 02 02 02
02 02 02 02 02 02 02 02 02 02 02 02 02 02 02 02 02 02 02 02 02 02 02 02 02 02 02 02 02 02 02 02 02 02 02 02 02 02 02 02 02 02 02 02 02 02 02 02 02 02
02 02 02 02 02 02 02 02 02 02 02 02 02 02 02 02 02 02 02 02 02 02 02 02 02 02 02 02 02 02 02 02 02 02 02 02 02 02 02 02 02 02 02 02 02 02 02 02 02 02
02 02 02 02 02 02 02 02 02 02 02 02 02 02 02 02 02 02 02 02 02 02 02 02 02 02 02 02 02 02 02 02 02 02 02 02 02 02 02 02 02 02 02 02 02 02 02 02 02 02
02 02 02 02 02 02 02 02 02 02 02 22 06 06 06 06 06 06 06 06 06 06 06 06 06 06 06 06 06 06 06 06 06 06 06 06 06 21 02 02 02 02 02 02 02 02 02 02 02 02
02 02 02 02 02 02 02 02 02 02 02 03 00 00 00 00 26 00 00 00 00 00 00 00 00 00 00 00 00 00 00 00 00 00 00 00 00 05 02 02 02 02 02 02 02 02 02 02 02 02
02 02 02 02 02 02 02 02 02 02 02 03 00 00 00 14 07 07 13 00 00 27 00 00 00 00 00 00 00 26 00 00 00 00 25 00 00 05 02 02 02 02 02 02 02 02 02 02 02 02
02 02 02 02 02 02 02 02 02 02 02 03 25 00 00 10 01 01 18 07 13 00 00 00 25 00 00 00 00 00 14 07 13 00 00 27 00 05 02 02 02 02 02 02 02 02 02 02 02 02
02 02 02 02 02 02 02 02 02 02 02 03 00 00 00 10 01 30 01 01 18 13 00 00 00 00 00 00 00 14 17 01 18 13 00 00 00 05 02 02 02 02 02 02 02 02 02 02 02 02
02 02 02 02 02 02 02 02 02 02 02 03 00 00 00 11 15 01 01 01 01 09 00 00 00 00 26 00 00 10 29 01 01 09 00 00 00 05 02 02 02 02 02 02 02 02 02 02 02 02
02 02 02 02 02 02 02 02 02 02 02 03 00 00 00 00 11 15 29 01 01 18 13 00 00 00 00 00 14 17 01 01 01 09 26 00 00 05 02 02 02 02 02 02 02 02 02 02 02 02
02 02 02 02 02 02 02 02 02 02 02 03 00 00 00 00 00 10 01 01 01 01 09 00 00 00 00 00 11 15 01 16 08 12 00 00 00 05 02 02 02 02 02 02 02 02 02 02 02 02
02 02 02 02 02 02 02 02 02 02 02 03 00 00 26 00 00 10 01 01 01 16 12 00 00 00 00 28 00 11 08 12 00 00 00 00 00 05 02 02 02 02 02 02 02 02 02 02 02 02
02 02 02 02 02 02 02 02 02 02 02 03 00 00 00 00 00 10 01 01 16 12 00 00 00 25 00 00 00 00 00 00 00 00 00 25 00 05 02 02 02 02 02 02 02 02 02 02 02 02
02 02 02 02 02 02 02 02 02 02 02 03 00 25 00 00 00 10 30 01 09 00 00 00 00 00 00 00 00 00 00 00 00 00 00 00 00 05 02 02 02 02 02 02 02 02 02 02 02 02
02 02 02 02 02 02 02 02 02 02 02 03 00 00 28 00 00 10 01 16 12 00 00 26 00 00 00 00 00 27 00 00 00 00 00 00 00 05 02 02 02 02 02 02 02 02 02 02 02 02
02 02 02 02 02 02 02 02 02 02 02 03 00 00 00 00 00 10 01 09 00 00 00 00 00 00 00 00 26 00 00 25 00 00 00 00 28 05 02 02 02 02 02 02 02 02 02 02 02 02
02 02 02 02 02 02 02 02 02 02 02 03 00 00 00 00 00 11 08 12 00 00 00 00 14 07 07 13 00 00 00 00 00 00 00 00 00 05 02 02 02 02 02 02 02 02 02 02 02 02
02 02 02 02 02 02 02 02 02 02 02 03 00 00 00 00 00 00 00 00 00 25 00 00 10 01 01 18 13 00 00 00 00 00 00 00 00 05 02 02 02 02 02 02 02 02 02 02 02 02
02 02 02 02 02 02 02 02 02 02 02 03 00 00 26 00 00 00 00 00 26 00 14 07 17 01 01 01 09 00 00 00 00 00 25 00 00 05 02 02 02 02 02 02 02 02 02 02 02 02
02 02 02 02 02 02 02 02 02 02 02 03 00 00 00 00 00 00 26 00 00 00 10 01 01 30 01 01 09 00 00 00 00 00 00 00 00 05 02 02 02 02 02 02 02 02 02 02 02 02
02 02 02 02 02 02 02 02 02 02 02 03 00 00 00 00 00 25 00 00 00 00 11 15 01 01 01 01 09 00 00 00 00 00 00 00 00 05 02 02 02 02 02 02 02 02 02 02 02 02
06 06 06 06 06 06 06 06 06 06 06 20 00 25 00 00 00 00 00 00 26 00 00 11 15 01 16 08 12 00 00 00 00 00 00 00 00 05 02 02 02 02 02 02 02 02 02 02 02 02
00 00 00 28 00 00 26 00 00 00 00 25 00 00 00 00 00 00 00 00 00 00 00 00 11 08 12 00 00 00 00 25 00 00 00 00 00 05 02 02 02 02 02 02 02 02 02 02 02 02
00 00 25 00 00 00 00 00 00 26 00 00 00 00 00 00 00 14 07 07 13 00 00 00 00 00 00 00 00 00 00 00 00 00 00 25 00 05 02 02 02 02 02 02 02 02 02 02 02 02
00 00 00 00 00 25 00 00 00 00 00 00 00 27 00 00 14 17 01 01 18 13 00 00 00 00 00 00 00 00 00 00 00 00 00 00 00 05 02 02 02 02 02 02 02 02 02 02 02 02
04 04 04 04 04 04 04 04 04 04 04 19 00 00 00 00 10 01 01 01 01 18 13 00 00 00 00 00 25 00 00 00 00 26 00 00 00 05 02 02 02 02 02 02 02 02 02 02 02 02
02 02 02 02 02 02 02 02 02 02 02 03 00 00 00 00 10 01 29 01 01 01 09 00 00 00 00 00 00 00 00 00 00 00 00 00 00 05 02 02 02 02 02 02 02 02 02 02 02 02
02 02 02 02 02 02 02 02 02 02 02 03 00 00 00 00 10 01 01 01 01 01 09 00 00 26 00 00 00 00 28 00 00 00 00 00 00 05 02 02 02 02 02 02 02 02 02 02 02 02
02 02 02 02 02 02 02 02 02 02 02 03 00 00 00 00 11 15 01 01 30 01 18 13 00 00 00 00 00 00 00 00 00 00 00 00 00 05 02 02 02 02 02 02 02 02 02 02 02 02
02 02 02 02 02 02 02 02 02 02 02 03 00 00 00 00 00 11 15 01 01 01 01 09 00 00 00 00 27 00 00 00 25 00 00 00 00 05 02 02 02 02 02 02 02 02 02 02 02 02
02 02 02 02 02 02 02 02 02 02 02 03 00 00 25 00 00 00 11 15 01 29 01 09 00 00 00 00 00 00 00 00 00 00 00 00 00 05 02 02 02 02 02 02 02 02 02 02 02 02
02 02 02 02 02 02 02 02 02 02 02 03 00 00 00 00 00 00 00 10 01 01 01 09 00 00 00 00 00 00 00 00 00 00 27 00 00 05 02 02 02 02 02 02 02 02 02 02 02 02
02 02 02 02 02 02 02 02 02 02 02 03 00 00 00 26 00 00 00 10 01 16 08 12 00 25 00 00 00 14 13 00 00 00 00 25 00 05 02 02 02 02 02 02 02 02 02 02 02 02
02 02 02 02 02 02 02 02 02 02 02 03 00 00 00 00 00 00 00 11 08 12 00 00 00 00 00 00 14 17 18 07 07 13 00 00 00 05 02 02 02 02 02 02 02 02 02 02 02 02
02 02 02 02 02 02 02 02 02 02 02 03 00 00 00 00 00 00 00 00 00 00 00 00 00 00 00 00 11 08 15 30 01 09 00 00 26 05 02 02 02 02 02 02 02 02 02 02 02 02
02 02 02 02 02 02 02 02 02 02 02 03 00 27 00 00 00 00 00 00 00 00 00 25 00 00 00 00 00 00 11 15 01 18 13 00 00 05 02 02 02 02 02 02 02 02 02 02 02 02
02 02 02 02 02 02 02 02 02 02 02 03 00 00 00 00 25 00 00 00 00 00 00 00 00 00 27 00 00 00 00 11 15 29 09 00 00 05 02 02 02 02 02 02 02 02 02 02 02 02
02 02 02 02 02 02 02 02 02 02 02 03 00 00 00 00 00 00 00 00 00 00 00 00 00 00 00 00 00 00 00 00 11 08 12 00 00 05 02 02 02 02 02 02 02 02 02 02 02 02
02 02 02 02 02 02 02 02 02 02 02 03 00 00 28 00 00 00 00 26 00 00 00 00 00 00 00 00 25 00 00 00 00 00 00 00 00 05 02 02 02 02 02 02 02 02 02 02 02 02
02 02 02 02 02 02 02 02 02 02 02 03 00 26 00 00 00 00 00 00 00 25 00 00 00 26 00 00 00 00 00 00 00 00 00 00 00 05 02 02 02 02 02 02 02 02 02 02 02 02
02 02 02 02 02 02 02 02 02 02 02 03 00 00 00 00 00 00 00 00 00 00 00 00 00 00 00 00 00 00 26 00 00 00 25 00 00 05 02 02 02 02 02 02 02 02 02 02 02 02
02 02 02 02 02 02 02 02 02 02 02 24 04 04 04 04 04 04 04 04 04 04 04 04 04 04 04 04 04 04 04 04 04 04 04 04 04 23 02 02 02 02 02 02 02 02 02 02 02 02
02 02 02 02 02 02 02 02 02 02 02 02 02 02 02 02 02 02 02 02 02 02 02 02 02 02 02 02 02 02 02 02 02 02 02 02 02 02 02 02 02 02 02 02 02 02 02 02 02 02
02 02 02 02 02 02 02 02 02 02 02 02 02 02 02 02 02 02 02 02 02 02 02 02 02 02 02 02 02 02 02 02 02 02 02 02 02 02 02 02 02 02 02 02 02 02 02 02 02 02
02 02 02 02 02 02 02 02 02 02 02 02 02 02 02 02 02 02 02 02 02 02 02 02 02 02 02 02 02 02 02 02 02 02 02 02 02 02 02 02 02 02 02 02 02 02 02 02 02 02
02 02 02 02 02 02 02 02 02 02 02 02 02 02 02 02 02 02 02 02 02 02 02 02 02 02 02 02 02 02 02 02 02 02 02 02 02 02 02 02 02 02 02 02 02 02 02 02 02 02
02 02 02 02 02 02 02 02 02 02 02 02 02 02 02 02 02 02 02 02 02 02 02 02 02 02 02 02 02 02 02 02 02 02 02 02 02 02 02 02 02 02 02 02 02 02 02 02 02 02
02 02 02 02 02 02 02 02 02 02 02 02 02 02 02 02 02 02 02 02 02 02 02 02 02 02 02 02 02 02 02 02 02 02 02 02 02 02 02 02 02 02 02 02 02 02 02 02 02 02